[map_begin]
2 2 2 s 2 2 2 2 2 2 2 2 2 2 2
2 2 2 0 2 2 0 0 2 0 0 0 e 0 0
2 2 2 0 2 2 0 2 2 0 1 2 2 2 2
0 0 0 0 1 0 0 0 1 0 2 2 2 2 2
2 2 0 1 0 0 2 0 2 0 2 2 2 2 2
2 2 0 0 0 2 2 0 1 0 2 2 2 2 2
2 2 0 0 1 2 2 0 0 0 2 2 2 2 2
2 1 0 0 0 0 0 0 2 2 2 2 2 2 2
0 0 0 2 2 2 2 2 2 2 2 2 2 2 2
s 2 2 2 2 2 2 2 2 2 2 2 2 2 2
[map_end]
[waves]
8