[map_begin]
2 2 2 2 s 2 2 2 2 2 2 2 e 2 2 2 2 2
2 2 2 2 0 2 2 1 0 0 0 0 0 0 0 0 2 2
2 2 2 2 0 2 2 2 0 2 2 2 0 2 2 2 2 2
2 2 2 1 0 2 2 2 0 0 0 0 0 0 0 0 2 2
2 0 0 0 0 2 2 2 2 1 2 2 2 2 2 0 l9 l0
2 0 1 2 2 2 2 0 0 0 0 0 0 1 2 0 l7 l8
2 0 2 2 2 2 2 0 2 2 2 2 0 2 2 0 l7 l8
2 0 0 0 0 2 2 0 1 2 2 2 0 2 2 0 l1 l3
2 2 2 2 0 2 2 0 0 0 0 2 0 2 2 0 2 2
2 2 l 2 0 2 1 2 2 2 0 2 0 2 2 0 2 2
2 2 2 2 0 0 0 0 0 0 0 2 0 0 0 0 2 2
2 2 2 2 2 2 2 2 2 2 2 2 2 2 2 2 2 2
[map_end]
[waves]
8